#.................................................
..................................................
..................................................
....#.............................................
.....#............................................
......#...........................................
.......##.........................................
........##........................................
.........##.......................................
..........###.....................................
...........###....................................
............###...................................
.............####.................................
...............###................................
................###...............................
.................####.............................
..................####............................
...................####...........................
....................#####.........................
.....................#####........................
......................#####.......................
.......................######.....................
........................######....................
.........................######...................
..........................#######.................
............................######................
.............................######...............
..............................#######.............
...............................#######............
................................#######...........
.................................########.........
..................................########........
...................................########.......
....................................#########.....
.....................................#########....
......................................#########...
.......................................##########.
.........................................#########
..........................................########
...........................................#######
............................................######
.............................................#####
..............................................####
...............................................###
................................................##
.................................................#
..................................................
..................................................
..................................................
..................................................

Total hits: 220
