|---------------------------------------------------------------------------------|
|                                                                                 |
|                                                                                 |
|                                                                                 |
|                                                                                 |
|                                                                                 |
|                                                                                 |
|                                                                                 |
|                                                                                 |
|                                                                                 |
|                                                                                 |
|                     ############### ### ########### #######                     |
|                    #...............#...#...........#.......#                    |
|                    #.#.###########.###.#.#.#########.#.####                     |
|                    #.#.....#...#.#.....#.#...........#.....#                    |
|                     ######.#.#.#.#####.#.#################.#                    |
|                    #.......#.#...#.....#.#.....#.........#.#                    |
|                    #.#######.#####.#####.###.#.#.#######.#.#                    |
|                    #.#.....#......D#...#.#...#.#.....#.#.#.#                    |
|                    #.#.###.#### ####.#.#.#.###.#####.#.#.#.#                    |
|                    #...#.#.#...#.....#...#.#...#.....#...#.#                    |
|                    #.###.#.#.#.#.#########.#####.#####.###.#                    |
|                    #.....#...#.........#...#...#.....#.#...#                    |
|                     ####.#### ########.#.###.#.#.###.#.###.#                    |
|                    #.........#.....#...#.#...#.#...#.#.#...#                    |
|                    #.#########.###.#.###.#.###.#####.#.#.#.#                    |
|                    #.#.......#.#.#.#.....#...#.......#...#.#                    |
|                     ##.#####.#.#.#.#######.#.######## ### .#                    |
|                    #...#...#.#...#.......#.#.........#...#.#                    |
|                    #.#####.#.###.#######.#####.#####.#.###.#                    |
|                    #.#...#.#.....#.....#.#...#...#.#.#.....#                    |
|                    #.#.#.#.#######.###.#.#.#.###.#.#.######                     |
|                    #.#.#.....#.#...#.#.#.#.#.#.....#.#.....#                    |
|                    #.#.#####.#.#.###.#.###.#.#####.#.#.###.#                    |
|                    #.#.#.....#.......#.....#.....#.#...#...#                    |
|                    #.#.#.#################.#####.#.#####.#.#                    |
|                    #...#...#.............#.#.....#.#...#.#.#                    |
|                     ### ##.#.#.#########.#.#.#######.#.#.#.#                    |
|                    #...#...#.#.#.....#.#...#...#.....#...#.#                    |
|                    #.###.#####.#.###.#.#######.###.#.#####.#                    |
|                    #...#.#.....#.#...#...#.....#...#.#...#.#                    |
|                     ##.#.#.#####.#.#####.#.#####.#####.#.##                     |
|                    #...#.#.#.....#.#.....#.....#.......#...#                    |
|                    #.###.#.#.#####.#.###.#####.#.#########.#                    |
|                    #...#...#.#.....#.#...#.....#.#...#.....#                    |
|                     ##.#####.#####.#.#.###.#####.###.#.###.#                    |
|                    #...#.....#...#...#...#.#.........#.#...#                    |
|                    #.###.###.#.#.#### ##.#.#.#########.#.##                     |
|                    #.....#O#.#.#.....#...#.#...#.....#.#.#.#                    |
|                    #.#####.#.#.#####.#####.#####.###.#.#.#.#                    |
|                    #.......#.......#.............#.....#...#                    |
|                     ####### ####### ############# ##### ###                     |
|                                                                                 |
|                                                                                 |
|                                                                                 |
|                                                                                 |
|                                                                                 |
|                                                                                 |
|                                                                                 |
|                                                                                 |
|                                                                                 |
|                                                                                 |
|---------------------------------------------------------------------------------|
