#########################################
#               #   #           #       #
# # ########### ### # # ######### # #####
# #     #   # #     # #           #     #
####### # # # ##### # ################# #
#       # #   #     # #     #         # #
# ####### ##### ##### ### # # ####### # #
# #     #       #   # #   # #     # # # #
# # ### ######### # # # ### ##### # # # #
#   # # #   #     #   # #   #     #   # #
# ### # # # # ######### ##### ##### ### #
#     #   #         #   #   #     # #   #
##### ############# # ### # # ### # ### #
#         #     #   # #   # #   # # #   #
# ######### ### # ### # ### ##### # # # #
# #       # # # #     #   #       #   # #
### ##### # # # ####### # ############# #
#   #   # #   #       # #         #   # #
# ##### # ### ####### ##### ##### # ### #
# #   # #     #     # #   #   # # #     #
# # # # ####### ### # # # ### # # #######
# # #     # #   # # # # # #     # #     #
# # ##### # # ### # ### # ##### # # ### #
# # #     #       #     #     # #   #   #
# # # ################# ##### # ##### # #
#   #   #             # #     # #   # # #
####### # # ######### # # ####### # # # #
#   #   # # #     # #   #   #     #   # #
# ### ##### # ### # ####### ### # ##### #
#   # #     # #   #   #     #   # #   # #
### # # ##### # ##### # ##### ##### # ###
#   # # #     # #     #     #       #   #
# ### # # ##### # ### ##### # ######### #
#   #   # #     # #   #     # #   #     #
### ##### ##### # # ### ##### ### # ### #
#   #     #   #   #   # #         # #   #
# ### ### # # ####### # # ######### # ###
#     #O# # #     #   # #   #     # # # #
# ##### # # ##### ##### ##### ### # # # #
#       #       #             #     #   #
#########################################
